乐看搜索 - com.letv.lesophoneclient
天气 - sina.mobile.tianqitongletv
语音控制 - com.mediatek.voicecommand
乐视视频 - com.letv.android.client
视频播放器 - com.letv.android.videoplayer
手机防盗 - com.mediatek.ppl
便签com.letv.android.note
万象搜索 - com.letv.android.quicksearchbox
乐视登录 - com.letv.android.agent
我的乐视 - com.letv.android.account
乐视live - com.letv.android.letvlive
下载 - com.android.providers.downloads.ui
乐视体育 - com.lesports.glivesports
乐视商城 - com.letv.letvshop
自带浏览器 - com.android.browser
应用商店 - com.letv.app.appstore
邮件 - com.android.email
推送服务 - com.stv.stvpush
乐视管家 - com.letv.android.supermanager
百度输入法 - com.baidu.input_letv
谷歌框架 - com.google.android.gsf
泡泡 - com.android.noisefield
涡轮下载 - com.mediatek.hetcomm
安卓键盘 - com.android.inputmethod.latin
搜狗输入法 - com.sohu.inputmethod.sogou.leshi
游戏中心 - com.letv.games
音乐 - com.android.music
问题反馈 - com.letv.android.bugreporter
指南针 - com.letv.android.compass
遥控器 - com.letv.android.remotecontrol
录音机 - com.letv.android.recorder
乐云 - com.letv.android.cloudservice
隐私授权 - com.letv.android.letvsafe
乐迷社区 - com.letv.bbs
免流量数据服务 - com.letv.android.freeflow